А где каки девушки,
А еще где каки голубушки?
Шадрински — калашницы;
А Осеевски — кисельницы;
Тарабаевски — квас продавать;
Тушановски — рукавицы вязать;
Мыльниковски девки — ягодницы;
Воробьевски — сухарницы;
Сухринскя — поповы кумы;
А Кушминскя — дьяконовы;
В Позвонковой — девки маленьк,
В косах ленточки аленьк;
Коврижскя — коренье копать;
Ячменевскя — себя заедать.
В Загайновской — дома толсты,
Тамо девушки на все дело просты;
Крутихинскя — спасалися,
По семи на сон бросалися;
У Коротковских — коротки дубасы
И не обрублены рубцы;
А Максимовски — догадушки:
Оне, к, догадывалися,
У дверей пяты подмазывали,
Крутихинских робят подманивали.
Безбожински — нечисты кулаки;
Яровскя девки — пл:
Охлебалися горошницы,
По загуменью валялися,
Рекрутов дожидалися.
Притыцки — бус воровать;
А Далматовски — ям держать;
Подкорыстовски — модницы;
Кривскя — недоросточки,
Поизмяли в лыгах косточки;
Дрянновски — сарапожницы;
Мальцовски — к обедне ходить;
Канашински — горшечницы;
Ивашевски — мешечницы;
Замараевски — платочницы,
Солдат любить охотницы.
