Хороша наша компанья;
Кто не хвалит, тот каналья.
Хороша наша волостка;
Про нее слава худая.
деры на-голо — то Устьяне мужики.
Живодеры на-голо — то Сельски мужики.
Толстоперсты, кривоперсты — Шпыловске мужики.
Вот без хлеба у воды — Оприсновск.
Толстоваты, мешковаты — то Даниловск.
Зубаны-то на-голо — то Климушинск.
Неспокойные соседи — то Давыдовск.
По два очепа в родник — то Данилихински.
Общеулы на-голо — то Зародовск.
Под озером живут — то Данниковски мужики.
Замараны ворота — то Филисовск.
Вот неткахи и непряхи — тут Плющевскя бабы;
Не ткут, не прядут, солдатам деньги отдают.
Без уголья куют — то Деревенски мужики.
Вот уроды на-голо — то Ивакинск.
Выкотепы на-голо — то Белавинск.
На чужое форсоваты — то Борисовск.
По чужим бабам ходить — то Останковск.
Кто захочет попилить, тот в Телицыно бежит.
Даровое вино пить — Митяковски мужики.
Вот Москва-то на-голо — Одарьинск.
На дорогу выбегают — Васиковски мужики.
Бойкя девчонки — то Кормиловск.
Лахмокурски мужики:
Перву тоню заметали, — им два мерина попали;
Другу тоню заметали, — им кобыла с жеребцом;
Третью тоню заметали, — им три девушки попали.
