А гдѣ каки дѣвушки,
А еще гдѣ каки голубушки?
Шадрински — калашницы;
А Осеевски — кисельницы;
Тарабаевски — квасъ продавать;
Тушановски — рукавицы вязать;
Мыльниковски дѣвки — ягодницы;
Воробьевски — сухарницы;
Сухринскія — поповы кумы;
А Кушминскія — дьяконовы;
Въ Позвонковой — дѣвки маленькія,
Въ косахъ ленточки аленькія;
Коврижскія — коренье копать;
Ячменевскія — себя заѣдать.
Въ Загайновской — дома толсты,

Тамо дѣвушки на все дѣло просты;
Крутихинскія — спасалися,
По семи на сонъ бросалися;
У Коротковскихъ — коротки дубасы
И не обрублены рубцы;
А Максимовски — догадушки:
Онѣ, к...., догадывалися,
У дверей пяты подмазывали,
Крутихинскихъ робятъ подманивали.
Безбожински — нечисты кулаки;
Яровскія дѣвки — пл....:
Охлебалися горошницы,
По загуменью валялися,
Рекрутовъ дожидалися.
Притыцки — бусъ воровать;
А Далматовски — ямъ держать;
Подкорыстовски — модницы;
Кривскія — недоросточки,
Поизмяли въ лыгахъ косточки;
Дрянновски — сарапожницы;
Мальцовски — къ обѣднѣ ходить;
Канашински — горшечницы;
Ивашевски — мѣшечницы;
Замараевски — платочницы,
Солдатъ любить охотницы.

